James	M
John	M
Robert	M
Michael	M
William	M
David	M
Richard	M
Charles	M
Joseph	M
Thomas	M
Christopher	M
Daniel	M
Paul	M
Mark	M
Donald	M
George	M
Kenneth	M
Steven	M
Edward	M
Brian	M
Ronald	M
Anthony	M
Kevin	M
Jason	M
Matthew	M
Gary	M
Timothy	M
Jose	M
Larry	M
Jeffrey	M
Frank	M
Scott	M
Eric	M
Stephen	M
Andrew	M
Raymond	M
Gregory	M
Joshua	M
Jerry	M
Dennis	M
Walter	M
Patrick	M
Peter	M
Harold	M
Douglas	M
Henry	M
Carl	M
Arthur	M
Ryan	M
Roger	M
Joe	M
Juan	M
Jack	M
Albert	M
Jonathan	M
Justin	M
Terry	M
Gerald	M
Keith	M
Samuel	M
Willie	M
Ralph	M
Lawrence	M
Nicholas	M
Roy	M
Benjamin	M
Bruce	M
Brandon	M
Adam	M
Harry	M
Fred	M
Wayne	M
Billy	M
Steve	M
Louis	M
Jeremy	M
Aaron	M
Randy	M
Howard	M
Eugene	M
Carlos	M
Russell	M
Bobby	M
Victor	M
Martin	M
Ernest	M
Phillip	M
Todd	M
Jesse	M
Craig	M
Alan	M
Shawn	M
Clarence	M
Sean	M
Philip	M
Chris	M
Johnny	M
Earl	M
Jimmy	M
Antonio	M
Danny	M
Bryan	M
Tony	M
Luis	M
Mike	M
Stanley	M
Leonard	M
Nathan	M
Dale	M
Manuel	M
Rodney	M
Curtis	M
Norman	M
Allen	M
Marvin	M
Vincent	M
Glenn	M
Jeffery	M
Travis	M
Jeff	M
Chad	M
Jacob	M
Lee	M
Melvin	M
Alfred	M
Kyle	M
Francis	M
Bradley	M
Jesus	M
Herbert	M
Frederick	M
Ray	M
Joel	M
Edwin	M
Don	M
Eddie	M
Ricky	M
Troy	M
Randall	M
Barry	M
Alexander	M
Bernard	M
Mario	M
Leroy	M
Francisco	M
Marcus	M
Micheal	M
Theodore	M
Clifford	M
Miguel	M
Oscar	M
Jay	M
Jim	M
Tom	M
Calvin	M
Alex	M
Jon	M
Ronnie	M
Bill	M
Lloyd	M
Tommy	M
Leon	M
Derek	M
Warren	M
Darrell	M
Jerome	M
Floyd	M
Leo	M
Alvin	M
Tim	M
Wesley	M
Gordon	M
Dean	M
Greg	M
Jorge	M
Dustin	M
Pedro	M
Derrick	M
Dan	M
Lewis	M
Zachary	M
Corey	M
Herman	M
Maurice	M
Vernon	M
Roberto	M
Clyde	M
Glen	M
Hector	M
Shane	M
Ricardo	M
Sam	M
Rick	M
Lester	M
Brent	M
Ramon	M
Charlie	M
Tyler	M
Gilbert	M
Gene	M
Marc	M
Reginald	M
Ruben	M
Brett	M
Angel	M
Nathaniel	M
Rafael	M
Leslie	M
Edgar	M
Milton	M
Raul	M
Ben	M
Chester	M
Cecil	M
Duane	M
Franklin	M
Andre	M
Elmer	M
Brad	M
Gabriel	M
Ron	M
Mitchell	M
Roland	M
Arnold	M
Harvey	M
Jared	M
Adrian	M
Karl	M
Cory	M
Claude	M
Erik	M
Darryl	M
Jamie	M
Neil	M
Jessie	M
Christian	M
Javier	M
Fernando	M
Clinton	M
Ted	M
Mathew	M
Tyrone	M
Darren	M
Lonnie	M
Lance	M
Cody	M
Julio	M
Kelly	M
Kurt	M
Allan	M
Nelson	M
Guy	M
Clayton	M
Hugh	M
Max	M
Dwayne	M
Dwight	M
Armando	M
Felix	M
Jimmie	M
Everett	M
Jordan	M
Ian	M
Wallace	M
Ken	M
Bob	M
Jaime	M
Casey	M
Alfredo	M
Alberto	M
Dave	M
Ivan	M
Johnnie	M
Sidney	M
Byron	M
Julian	M
Isaac	M
Morris	M
Clifton	M
Willard	M
Daryl	M
Ross	M
Virgil	M
Andy	M
Marshall	M
Salvador	M
Perry	M
Kirk	M
Sergio	M
Marion	M
Tracy	M
Seth	M
Kent	M
Terrance	M
Rene	M
Eduardo	M
Terrence	M
Enrique	M
Freddie	M
Wade	M
Austin	M
Stuart	M
Fredrick	M
Arturo	M
Alejandro	M
Jackie	M
Joey	M
Nick	M
Luther	M
Wendell	M
Jeremiah	M
Evan	M
Julius	M
Dana	M
Donnie	M
Otis	M
Shannon	M
Trevor	M
Oliver	M
Luke	M
Homer	M
Gerard	M
Doug	M
Kenny	M
Hubert	M
Angelo	M
Shaun	M
Lyle	M
Matt	M
Lynn	M
Alfonso	M
Orlando	M
Rex	M
Carlton	M
Ernesto	M
Cameron	M
Neal	M
Pablo	M
Lorenzo	M
Omar	M
Wilbur	M
Blake	M
Grant	M
Horace	M
Roderick	M
Kerry	M
Abraham	M
Willis	M
Rickey	M
Jean	M
Ira	M
Andres	M
Cesar	M
Johnathan	M
Malcolm	M
Rudolph	M
Damon	M
Kelvin	M
Rudy	M
Preston	M
Alton	M
Archie	M
Marco	M
Wm	M
Pete	M
Randolph	M
Garry	M
Geoffrey	M
Jonathon	M
Felipe	M
Bennie	M
Gerardo	M
Ed	M
Dominic	M
Robin	M
Loren	M
Delbert	M
Colin	M
Guillermo	M
Earnest	M
Lucas	M
Benny	M
Noel	M
Spencer	M
Rodolfo	M
Myron	M
Edmund	M
Garrett	M
Salvatore	M
Cedric	M
Lowell	M
Gregg	M
Sherman	M
Wilson	M
Devin	M
Sylvester	M
Kim	M
Roosevelt	M
Israel	M
Jermaine	M
Forrest	M
Wilbert	M
Leland	M
Simon	M
Guadalupe	M
Clark	M
Irving	M
Carroll	M
Bryant	M
Owen	M
Rufus	M
Woodrow	M
Sammy	M
Kristopher	M
Mack	M
Levi	M
Marcos	M
Gustavo	M
Jake	M
Lionel	M
Marty	M
Taylor	M
Ellis	M
Dallas	M
Gilberto	M
Clint	M
Nicolas	M
Laurence	M
Ismael	M
Orville	M
Drew	M
Jody	M
Ervin	M
Dewey	M
Al	M
Wilfred	M
Josh	M
Hugo	M
Ignacio	M
Caleb	M
Tomas	M
Sheldon	M
Erick	M
Frankie	M
Stewart	M
Doyle	M
Darrel	M
Rogelio	M
Terence	M
Santiago	M
Alonzo	M
Elias	M
Bert	M
Elbert	M
Ramiro	M
Conrad	M
Pat	M
Noah	M
Grady	M
Phil	M
Cornelius	M
Lamar	M
Rolando	M
Clay	M
Percy	M
Dexter	M
Bradford	M
Merle	M
Darin	M
Amos	M
Terrell	M
Moses	M
Irvin	M
Saul	M
Roman	M
Darnell	M
Randal	M
Tommie	M
Timmy	M
Darrin	M
Winston	M
Brendan	M
Toby	M
Van	M
Abel	M
Dominick	M
Boyd	M
Courtney	M
Jan	M
Emilio	M
Elijah	M
Cary	M
Domingo	M
Santos	M
Aubrey	M
Emmett	M
Marlon	M
Emanuel	M
Jerald	M
Edmond	M
Emil	M
Dewayne	M
Will	M
Otto	M
Teddy	M
Reynaldo	M
Bret	M
Morgan	M
Jess	M
Trent	M
Humberto	M
Emmanuel	M
Stephan	M
Louie	M
Vicente	M
Lamont	M
Stacy	M
Garland	M
Miles	M
Micah	M
Efrain	M
Billie	M
Logan	M
Heath	M
Rodger	M
Harley	M
Demetrius	M
Ethan	M
Eldon	M
Rocky	M
Pierre	M
Junior	M
Freddy	M
Eli	M
Bryce	M
Antoine	M
Robbie	M
Kendall	M
Royce	M
Sterling	M
Mickey	M
Chase	M
Grover	M
Elton	M
Cleveland	M
Dylan	M
Chuck	M
Damian	M
Reuben	M
Stan	M
August	M
Leonardo	M
Jasper	M
Russel	M
Erwin	M
Benito	M
Hans	M
Monte	M
Blaine	M
Ernie	M
Curt	M
Quentin	M
Agustin	M
Murray	M
Jamal	M
Devon	M
Adolfo	M
Harrison	M
Tyson	M
Burton	M
Brady	M
Elliott	M
Wilfredo	M
Bart	M
Jarrod	M
Vance	M
Denis	M
Damien	M
Joaquin	M
Harlan	M
Desmond	M
Elliot	M
Darwin	M
Ashley	M
Gregorio	M
Buddy	M
Xavier	M
Kermit	M
Roscoe	M
Esteban	M
Anton	M
Solomon	M
Scotty	M
Norbert	M
Elvin	M
Williams	M
Nolan	M
Carey	M
Rod	M
Quinton	M
Hal	M
Brain	M
Rob	M
Elwood	M
Kendrick	M
Darius	M
Moises	M
Son	M
Marlin	M
Fidel	M
Thaddeus	M
Cliff	M
Marcel	M
Ali	M
Jackson	M
Raphael	M
Bryon	M
Armand	M
Alvaro	M
Jeffry	M
Dane	M
Joesph	M
Thurman	M
Ned	M
Sammie	M
Rusty	M
Michel	M
Monty	M
Rory	M
Fabian	M
Reggie	M
Mason	M
Graham	M
Kris	M
Isaiah	M
Vaughn	M
Gus	M
Avery	M
Loyd	M
Diego	M
Alexis	M
Adolph	M
Norris	M
Millard	M
Rocco	M
Gonzalo	M
Derick	M
Rodrigo	M
Gerry	M
Stacey	M
Carmen	M
Wiley	M
Rigoberto	M
Alphonso	M
Ty	M
Shelby	M
Rickie	M
Noe	M
Vern	M
Bobbie	M
Reed	M
Jefferson	M
Elvis	M
Bernardo	M
Mauricio	M
Hiram	M
Donovan	M
Basil	M
Riley	M
Ollie	M
Nickolas	M
Maynard	M
Scot	M
Vince	M
Quincy	M
Eddy	M
Sebastian	M
Federico	M
Ulysses	M
Heriberto	M
Donnell	M
Cole	M
Denny	M
Davis	M
Gavin	M
Emery	M
Ward	M
Romeo	M
Jayson	M
Dion	M
Dante	M
Clement	M
Coy	M
Odell	M
Maxwell	M
Jarvis	M
Bruno	M
Issac	M
Mary	M
Dudley	M
Brock	M
Sanford	M
Colby	M
Carmelo	M
Barney	M
Nestor	M
Hollis	M
Stefan	M
Donny	M
Art	M
Linwood	M
Beau	M
Weldon	M
Galen	M
Isidro	M
Truman	M
Delmar	M
Johnathon	M
Silas	M
Frederic	M
Dick	M
Kirby	M
Irwin	M
Cruz	M
Merlin	M
Merrill	M
Charley	M
Marcelino	M
Lane	M
Harris	M
Cleo	M
Carlo	M
Trenton	M
Kurtis	M
Hunter	M
Aurelio	M
Winfred	M
Vito	M
Collin	M
Denver	M
Carter	M
Leonel	M
Emory	M
Pasquale	M
Mohammad	M
Mariano	M
Danial	M
Blair	M
Landon	M
Dirk	M
Branden	M
Adan	M
Numbers	M
Clair	M
Buford	M
German	M
Bernie	M
Wilmer	M
Joan	M
Emerson	M
Zachery	M
Fletcher	M
Jacques	M
Errol	M
Dalton	M
Monroe	M
Josue	M
Dominique	M
Edwardo	M
Booker	M
Wilford	M
Sonny	M
Shelton	M
Carson	M
Theron	M
Raymundo	M
Daren	M
Tristan	M
Houston	M
Robby	M
Lincoln	M
Jame	M
Genaro	M
Gale	M
Bennett	M
Octavio	M
Cornell	M
Laverne	M
Hung	M
Arron	M
Antony	M
Herschel	M
Alva	M
Giovanni	M
Garth	M
Cyrus	M
Cyril	M
Ronny	M
Stevie	M
Lon	M
Freeman	M
Erin	M
Duncan	M
Kennith	M
Carmine	M
Augustine	M
Young	M
Erich	M
Chadwick	M
Wilburn	M
Russ	M
Reid	M
Myles	M
Anderson	M
Morton	M
Jonas	M
Forest	M
Mitchel	M
Mervin	M
Zane	M
Rich	M
Jamel	M
Lazaro	M
Alphonse	M
Randell	M
Major	M
Johnie	M
Jarrett	M
Brooks	M
Ariel	M
Abdul	M
Dusty	M
Luciano	M
Lindsey	M
Tracey	M
Seymour	M
Scottie	M
Eugenio	M
Mohammed	M
Sandy	M
Valentin	M
Chance	M
Arnulfo	M
Lucien	M
Ferdinand	M
Thad	M
Ezra	M
Sydney	M
Aldo	M
Rubin	M
Royal	M
Mitch	M
Earle	M
Abe	M
Wyatt	M
Marquis	M
Lanny	M
Kareem	M
Jamar	M
Boris	M
Isiah	M
Emile	M
Elmo	M
Aron	M
Leopoldo	M
Everette	M
Josef	M
Gail	M
Eloy	M
Dorian	M
Rodrick	M
Reinaldo	M
Lucio	M
Jerrod	M
Weston	M
Hershel	M
Barton	M
Parker	M
Lemuel	M
Lavern	M
Burt	M
Jules	M
Gil	M
Eliseo	M
Ahmad	M
Nigel	M
Efren	M
Antwan	M
Alden	M
Margarito	M
Coleman	M
Refugio	M
Dino	M
Osvaldo	M
Les	M
Deandre	M
Normand	M
Kieth	M
Ivory	M
Andrea	M
Trey	M
Norberto	M
Napoleon	M
Jerold	M
Fritz	M
Rosendo	M
Milford	M
Sang	M
Deon	M
Christoper	M
Alfonzo	M
Lyman	M
Josiah	M
Brant	M
Wilton	M
Rico	M
Jamaal	M
Dewitt	M
Carol	M
Brenton	M
Yong	M
Olin	M
Foster	M
Faustino	M
Claudio	M
Judson	M
Gino	M
Edgardo	M
Berry	M
Alec	M
Tanner	M
Jarred	M
Donn	M
Trinidad	M
Tad	M
Shirley	M
Prince	M
Porfirio	M
Odis	M
Maria	M
Lenard	M
Chauncey	M
Chang	M
Tod	M
Mel	M
Marcelo	M
Kory	M
Augustus	M
Keven	M
Hilario	M
Bud	M
Sal	M
Rosario	M
Orval	M
Mauro	M
Dannie	M
Zachariah	M
Olen	M
Anibal	M
Milo	M
Jed	M
Frances	M
Thanh	M
Dillon	M
Amado	M
Newton	M
Connie	M
Lenny	M
Tory	M
Richie	M
Lupe	M
Horacio	M
Brice	M
Mohamed	M
Delmer	M
Dario	M
Reyes	M
Dee	M
Mac	M
Jonah	M
Jerrold	M
Robt	M
Hank	M
Sung	M
Rupert	M
Rolland	M
Kenton	M
Damion	M
Chi	M
Antone	M
Waldo	M
Fredric	M
Bradly	M
Quinn	M
Kip	M
Burl	M
Walker	M
Tyree	M
Jefferey	M
Ahmed	M
Willy	M
Stanford	M
Oren	M
Noble	M
Moshe	M
Mikel	M
Enoch	M
Brendon	M
Quintin	M
Jamison	M
Florencio	M
Darrick	M
Tobias	M
Minh	M
Hassan	M
Giuseppe	M
Demarcus	M
Cletus	M
Tyrell	M
Lyndon	M
Keenan	M
Werner	M
Theo	M
Geraldo	M
Lou	M
Columbus	M
Chet	M
Bertram	M
Markus	M
Huey	M
Hilton	M
Dwain	M
Donte	M
Tyron	M
Omer	M
Isaias	M
Hipolito	M
Fermin	M
Chung	M
Adalberto	M
Valentine	M
Jamey	M
Bo	M
Barrett	M
Whitney	M
Teodoro	M
Mckinley	M
Maximo	M
Garfield	M
Sol	M
Raleigh	M
Lawerence	M
Abram	M
Rashad	M
King	M
Emmitt	M
Daron	M
Chong	M
Samual	M
Paris	M
Otha	M
Miquel	M
Lacy	M
Eusebio	M
Dong	M
Domenic	M
Darron	M
Buster	M
Antonia	M
Wilber	M
Renato	M
Jc	M
Hoyt	M
Haywood	M
Ezekiel	M
Chas	M
Florentino	M
Elroy	M
Clemente	M
Arden	M
Neville	M
Kelley	M
Edison	M
Deshawn	M
Carrol	M
Shayne	M
Nathanial	M
Jordon	M
Danilo	M
Claud	M
Val	M
Sherwood	M
Raymon	M
Rayford	M
Cristobal	M
Ambrose	M
Titus	M
Hyman	M
Felton	M
Ezequiel	M
Erasmo	M
Stanton	M
Lonny	M
Len	M
Ike	M
Milan	M
Lino	M
Jarod	M
Herb	M
Andreas	M
Walton	M
Rhett	M
Palmer	M
Jude	M
Douglass	M
Cordell	M
Oswaldo	M
Ellsworth	M
Virgilio	M
Toney	M
Nathanael	M
Del	M
Britt	M
Benedict	M
Mose	M
Hong	M
Leigh	M
Johnson	M
Isreal	M
Gayle	M
Garret	M
Fausto	M
Asa	M
Arlen	M
Zack	M
Warner	M
Modesto	M
Francesco	M
Manual	M
Jae	M
Gaylord	M
Gaston	M
Filiberto	M
Deangelo	M
Michale	M
Granville	M
Wes	M
Malik	M
Zackary	M
Tuan	M
Nicky	M
Eldridge	M
Cristopher	M
Cortez	M
Antione	M
Malcom	M
Long	M
Korey	M
Jospeh	M
Colton	M
Waylon	M
Von	M
Hosea	M
Shad	M
Santo	M
Rudolf	M
Rolf	M
Rey	M
Renaldo	M
Marcellus	M
Lucius	M
Lesley	M
Kristofer	M
Boyce	M
Benton	M
Man	M
Kasey	M
Jewell	M
Hayden	M
Harland	M
Arnoldo	M
Rueben	M
Leandro	M
Kraig	M
Jerrell	M
Jeromy	M
Hobert	M
Cedrick	M
Arlie	M
Winford	M
Wally	M
Patricia	M
Luigi	M
Keneth	M
Jacinto	M
Graig	M
Franklyn	M
Edmundo	M
Sid	M
Porter	M
Leif	M
Lauren	M
Jeramy	M
Elisha	M
Buck	M
Willian	M
Vincenzo	M
Shon	M
Michal	M
Lynwood	M
Lindsay	M
Jewel	M
Jere	M
Hai	M
Elden	M
Dorsey	M
Darell	M
Broderick	M
Alonso	M
Mary	F
Patricia	F
Linda	F
Barbara	F
Elizabeth	F
Jennifer	F
Maria	F
Susan	F
Margaret	F
Dorothy	F
Lisa	F
Nancy	F
Karen	F
Betty	F
Helen	F
Sandra	F
Donna	F
Carol	F
Ruth	F
Sharon	F
Michelle	F
Laura	F
Sarah	F
Kimberly	F
Deborah	F
Jessica	F
Shirley	F
Cynthia	F
Angela	F
Melissa	F
Brenda	F
Amy	F
Anna	F
Rebecca	F
Virginia	F
Kathleen	F
Pamela	F
Martha	F
Debra	F
Amanda	F
Stephanie	F
Carolyn	F
Christine	F
Marie	F
Janet	F
Catherine	F
Frances	F
Ann	F
Joyce	F
Diane	F
Alice	F
Julie	F
Heather	F
Teresa	F
Doris	F
Gloria	F
Evelyn	F
Jean	F
Cheryl	F
Mildred	F
Katherine	F
Joan	F
Ashley	F
Judith	F
Rose	F
Janice	F
Kelly	F
Nicole	F
Judy	F
Christina	F
Kathy	F
Theresa	F
Beverly	F
Denise	F
Tammy	F
Irene	F
Jane	F
Lori	F
Rachel	F
Marilyn	F
Andrea	F
Kathryn	F
Louise	F
Sara	F
Anne	F
Jacqueline	F
Wanda	F
Bonnie	F
Julia	F
Ruby	F
Lois	F
Tina	F
Phyllis	F
Norma	F
Paula	F
Diana	F
Annie	F
Lillian	F
Emily	F
Robin	F
Peggy	F
Crystal	F
Gladys	F
Rita	F
Dawn	F
Connie	F
Florence	F
Tracy	F
Edna	F
Tiffany	F
Carmen	F
Rosa	F
Cindy	F
Grace	F
Wendy	F
Victoria	F
Edith	F
Kim	F
Sherry	F
Sylvia	F
Josephine	F
Thelma	F
Shannon	F
Sheila	F
Ethel	F
Ellen	F
Elaine	F
Marjorie	F
Carrie	F
Charlotte	F
Monica	F
Esther	F
Pauline	F
Emma	F
Juanita	F
Anita	F
Rhonda	F
Hazel	F
Amber	F
Eva	F
Debbie	F
April	F
Leslie	F
Clara	F
Lucille	F
Jamie	F
Joanne	F
Eleanor	F
Valerie	F
Danielle	F
Megan	F
Alicia	F
Suzanne	F
Michele	F
Gail	F
Bertha	F
Darlene	F
Veronica	F
Jill	F
Erin	F
Geraldine	F
Lauren	F
Cathy	F
Joann	F
Lorraine	F
Lynn	F
Sally	F
Regina	F
Erica	F
Beatrice	F
Dolores	F
Bernice	F
Audrey	F
Yvonne	F
Annette	F
June	F
Samantha	F
Marion	F
Dana	F
Stacy	F
Ana	F
Renee	F
Ida	F
Vivian	F
Roberta	F
Holly	F
Brittany	F
Melanie	F
Loretta	F
Yolanda	F
Jeanette	F
Laurie	F
Katie	F
Kristen	F
Vanessa	F
Alma	F
Sue	F
Elsie	F
Beth	F
Jeanne	F
Vicki	F
Carla	F
Tara	F
Rosemary	F
Eileen	F
Terri	F
Gertrude	F
Lucy	F
Tonya	F
Ella	F
Stacey	F
Wilma	F
Gina	F
Kristin	F
Jessie	F
Natalie	F
Agnes	F
Vera	F
Willie	F
Charlene	F
Bessie	F
Delores	F
Melinda	F
Pearl	F
Arlene	F
Maureen	F
Colleen	F
Allison	F
Tamara	F
Joy	F
Georgia	F
Constance	F
Lillie	F
Claudia	F
Jackie	F
Marcia	F
Tanya	F
Nellie	F
Minnie	F
Marlene	F
Heidi	F
Glenda	F
Lydia	F
Viola	F
Courtney	F
Marian	F
Stella	F
Caroline	F
Dora	F
Jo	F
Vickie	F
Mattie	F
Terry	F
Maxine	F
Irma	F
Mabel	F
Marsha	F
Myrtle	F
Lena	F
Christy	F
Deanna	F
Patsy	F
Hilda	F
Gwendolyn	F
Jennie	F
Nora	F
Margie	F
Nina	F
Cassandra	F
Leah	F
Penny	F
Kay	F
Priscilla	F
Naomi	F
Carole	F
Brandy	F
Olga	F
Billie	F
Dianne	F
Tracey	F
Leona	F
Jenny	F
Felicia	F
Sonia	F
Miriam	F
Velma	F
Becky	F
Bobbie	F
Violet	F
Kristina	F
Toni	F
Misty	F
Mae	F
Shelly	F
Daisy	F
Ramona	F
Sherri	F
Erika	F
Katrina	F
Claire	F
Lindsey	F
Lindsay	F
Geneva	F
Guadalupe	F
Belinda	F
Margarita	F
Sheryl	F
Cora	F
Faye	F
Ada	F
Natasha	F
Sabrina	F
Isabel	F
Marguerite	F
Hattie	F
Harriet	F
Molly	F
Cecilia	F
Kristi	F
Brandi	F
Blanche	F
Sandy	F
Rosie	F
Joanna	F
Iris	F
Eunice	F
Angie	F
Inez	F
Lynda	F
Madeline	F
Amelia	F
Alberta	F
Genevieve	F
Monique	F
Jodi	F
Janie	F
Maggie	F
Kayla	F
Sonya	F
Jan	F
Lee	F
Kristine	F
Candace	F
Fannie	F
Maryann	F
Opal	F
Alison	F
Yvette	F
Melody	F
Luz	F
Susie	F
Olivia	F
Flora	F
Shelley	F
Kristy	F
Mamie	F
Lula	F
Lola	F
Verna	F
Beulah	F
Antoinette	F
Candice	F
Juana	F
Jeannette	F
Pam	F
Kelli	F
Hannah	F
Whitney	F
Bridget	F
Karla	F
Celia	F
Latoya	F
Patty	F
Shelia	F
Gayle	F
Della	F
Vicky	F
Lynne	F
Sheri	F
Marianne	F
Kara	F
Jacquelyn	F
Erma	F
Blanca	F
Myra	F
Leticia	F
Pat	F
Krista	F
Roxanne	F
Angelica	F
Johnnie	F
Robyn	F
Francis	F
Adrienne	F
Rosalie	F
Alexandra	F
Brooke	F
Bethany	F
Sadie	F
Bernadette	F
Traci	F
Jody	F
Kendra	F
Jasmine	F
Nichole	F
Rachael	F
Chelsea	F
Mable	F
Ernestine	F
Muriel	F
Marcella	F
Elena	F
Krystal	F
Angelina	F
Nadine	F
Kari	F
Estelle	F
Dianna	F
Paulette	F
Lora	F
Mona	F
Doreen	F
Rosemarie	F
Angel	F
Desiree	F
Antonia	F
Hope	F
Ginger	F
Janis	F
Betsy	F
Christie	F
Freda	F
Mercedes	F
Meredith	F
Lynette	F
Teri	F
Cristina	F
Eula	F
Leigh	F
Meghan	F
Sophia	F
Eloise	F
Rochelle	F
Gretchen	F
Cecelia	F
Raquel	F
Henrietta	F
Alyssa	F
Jana	F
Kelley	F
Gwen	F
Kerry	F
Jenna	F
Tricia	F
Laverne	F
Olive	F
Alexis	F
Tasha	F
Silvia	F
Elvira	F
Casey	F
Delia	F
Sophie	F
Kate	F
Patti	F
Lorena	F
Kellie	F
Sonja	F
Lila	F
Lana	F
Darla	F
May	F
Mindy	F
Essie	F
Mandy	F
Lorene	F
Elsa	F
Josefina	F
Jeannie	F
Miranda	F
Dixie	F
Lucia	F
Marta	F
Faith	F
Lela	F
Johanna	F
Shari	F
Camille	F
Tami	F
Shawna	F
Elisa	F
Ebony	F
Melba	F
Ora	F
Nettie	F
Tabitha	F
Ollie	F
Jaime	F
Winifred	F
Kristie	F
Marina	F
Alisha	F
Aimee	F
Rena	F
Myrna	F
Marla	F
Tammie	F
Latasha	F
Bonita	F
Patrice	F
Ronda	F
Sherrie	F
Addie	F
Francine	F
Deloris	F
Stacie	F
Adriana	F
Cheri	F
Shelby	F
Abigail	F
Celeste	F
Jewel	F
Cara	F
Adele	F
Rebekah	F
Lucinda	F
Dorthy	F
Chris	F
Effie	F
Trina	F
Reba	F
Shawn	F
Sallie	F
Aurora	F
Lenora	F
Etta	F
Lottie	F
Kerri	F
Trisha	F
Nikki	F
Estella	F
Francisca	F
Josie	F
Tracie	F
Marissa	F
Karin	F
Brittney	F
Janelle	F
Lourdes	F
Laurel	F
Helene	F
Fern	F
Elva	F
Corinne	F
Kelsey	F
Ina	F
Bettie	F
Elisabeth	F
Aida	F
Caitlin	F
Ingrid	F
Iva	F
Eugenia	F
Christa	F
Goldie	F
Cassie	F
Maude	F
Jenifer	F
Therese	F
Frankie	F
Dena	F
Lorna	F
Janette	F
Latonya	F
Candy	F
Morgan	F
Consuelo	F
Tamika	F
Rosetta	F
Debora	F
Cherie	F
Polly	F
Dina	F
Jewell	F
Fay	F
Jillian	F
Dorothea	F
Nell	F
Trudy	F
Esperanza	F
Patrica	F
Kimberley	F
Shanna	F
Helena	F
Carolina	F
Cleo	F
Stefanie	F
Rosario	F
Ola	F
Janine	F
Mollie	F
Lupe	F
Alisa	F
Lou	F
Maribel	F
Susanne	F
Bette	F
Susana	F
Elise	F
Cecile	F
Isabelle	F
Lesley	F
Jocelyn	F
Paige	F
Joni	F
Rachelle	F
Leola	F
Daphne	F
Alta	F
Ester	F
Petra	F
Graciela	F
Imogene	F
Jolene	F
Keisha	F
Lacey	F
Glenna	F
Gabriela	F
Keri	F
Ursula	F
Lizzie	F
Kirsten	F
Shana	F
Adeline	F
Mayra	F
Jayne	F
Jaclyn	F
Gracie	F
Sondra	F
Carmela	F
Marisa	F
Rosalind	F
Charity	F
Tonia	F
Beatriz	F
Marisol	F
Clarice	F
Jeanine	F
Sheena	F
Angeline	F
Frieda	F
Lily	F
Robbie	F
Shauna	F
Millie	F
Claudette	F
Cathleen	F
Angelia	F
Gabrielle	F
Autumn	F
Katharine	F
Summer	F
Jodie	F
Staci	F
Lea	F
Christi	F
Jimmie	F
Justine	F
Elma	F
Luella	F
Margret	F
Dominique	F
Socorro	F
Rene	F
Martina	F
Margo	F
Mavis	F
Callie	F
Bobbi	F
Maritza	F
Lucile	F
Leanne	F
Jeannine	F
Deana	F
Aileen	F
Lorie	F
Ladonna	F
Willa	F
Manuela	F
Gale	F
Selma	F
Dolly	F
Sybil	F
Abby	F
Lara	F
Dale	F
Ivy	F
Dee	F
Winnie	F
Marcy	F
Luisa	F
Jeri	F
Magdalena	F
Ofelia	F
Meagan	F
Audra	F
Matilda	F
Leila	F
Cornelia	F
Bianca	F
Simone	F
Bettye	F
Randi	F
Virgie	F
Latisha	F
Barbra	F
Georgina	F
Eliza	F
Leann	F
Bridgette	F
Rhoda	F
Haley	F
Adela	F
Nola	F
Bernadine	F
Flossie	F
Ila	F
Greta	F
Ruthie	F
Nelda	F
Minerva	F
Lilly	F
Terrie	F
Letha	F
Hilary	F
Estela	F
Valarie	F
Brianna	F
Rosalyn	F
Earline	F
Catalina	F
Ava	F
Mia	F
Clarissa	F
Lidia	F
Corrine	F
Alexandria	F
Concepcion	F
Tia	F
Sharron	F
Rae	F
Dona	F
Ericka	F
Jami	F
Elnora	F
Chandra	F
Lenore	F
Neva	F
Marylou	F
Melisa	F
Tabatha	F
Serena	F
Avis	F
Allie	F
Sofia	F
Jeanie	F
Odessa	F
Nannie	F
Harriett	F
Loraine	F
Penelope	F
Milagros	F
Emilia	F
Benita	F
Allyson	F
Ashlee	F
Tania	F
Tommie	F
Esmeralda	F
Karina	F
Eve	F
Pearlie	F
Zelma	F
Malinda	F
Noreen	F
Tameka	F
Saundra	F
Hillary	F
Amie	F
Althea	F
Rosalinda	F
Jordan	F
Lilia	F
Alana	F
Gay	F
Clare	F
Alejandra	F
Elinor	F
Michael	F
Lorrie	F
Jerri	F
Darcy	F
Earnestine	F
Carmella	F
Taylor	F
Noemi	F
Marcie	F
Liza	F
Annabelle	F
Louisa	F
Earlene	F
Mallory	F
Carlene	F
Nita	F
Selena	F
Tanisha	F
Katy	F
Julianne	F
John	F
Lakisha	F
Edwina	F
Maricela	F
Margery	F
Kenya	F
Dollie	F
Roxie	F
Roslyn	F
Kathrine	F
Nanette	F
Charmaine	F
Lavonne	F
Ilene	F
Kris	F
Tammi	F
Suzette	F
Corine	F
Kaye	F
Jerry	F
Merle	F
Chrystal	F
Lina	F
Deanne	F
Lilian	F
Juliana	F
Aline	F
Luann	F
Kasey	F
Maryanne	F
Evangeline	F
Colette	F
Melva	F
Lawanda	F
Yesenia	F
Nadia	F
Madge	F
Kathie	F
Eddie	F
Ophelia	F
Valeria	F
Nona	F
Mitzi	F
Mari	F
Georgette	F
Claudine	F
Fran	F
Alissa	F
Roseann	F
Lakeisha	F
Susanna	F
Reva	F
Deidre	F
Chasity	F
Sheree	F
Carly	F
James	F
Elvia	F
Alyce	F
Deirdre	F
Gena	F
Briana	F
Araceli	F
Katelyn	F
Rosanne	F
Wendi	F
Tessa	F
Berta	F
Marva	F
Imelda	F
Marietta	F
Marci	F
Leonor	F
Arline	F
Sasha	F
Madelyn	F
Janna	F
Juliette	F
Deena	F
Aurelia	F
Josefa	F
Augusta	F
Liliana	F
Young	F
Christian	F
Lessie	F
Amalia	F
Savannah	F
Anastasia	F
Vilma	F
Natalia	F
Rosella	F
Lynnette	F
Corina	F
Alfreda	F
Leanna	F
Carey	F
Amparo	F
Coleen	F
Tamra	F
Aisha	F
Wilda	F
Karyn	F
Cherry	F
Queen	F
Maura	F
Mai	F
Evangelina	F
Rosanna	F
Hallie	F
Erna	F
Enid	F
Mariana	F
Lacy	F
Juliet	F
Jacklyn	F
Freida	F
Madeleine	F
Mara	F
Hester	F
Cathryn	F
Lelia	F
Casandra	F
Bridgett	F
Angelita	F
Jannie	F
Dionne	F
Annmarie	F
Katina	F
Beryl	F
Phoebe	F
Millicent	F
Katheryn	F
Diann	F
Carissa	F
Maryellen	F
Liz	F
Lauri	F
Helga	F
Gilda	F
Adrian	F
Rhea	F
Marquita	F
Hollie	F
Tisha	F
Tamera	F
Angelique	F
Francesca	F
Britney	F
Kaitlin	F
Lolita	F
Florine	F
Rowena	F
Reyna	F
Twila	F
Fanny	F
Janell	F
Ines	F
Concetta	F
Bertie	F
Alba	F
Brigitte	F
Alyson	F
Vonda	F
Pansy	F
Elba	F
Noelle	F
Letitia	F
Kitty	F
Deann	F
Brandie	F
Louella	F
Leta	F
Felecia	F
Sharlene	F
Lesa	F
Beverley	F
Robert	F
Isabella	F
Herminia	F
Terra	F
Celina	F
Tori	F
Octavia	F
Jade	F
Denice	F
Germaine	F
Sierra	F
Michell	F
Cortney	F
Nelly	F
Doretha	F
Sydney	F
Deidra	F
Monika	F
Lashonda	F
Judi	F
Chelsey	F
Antionette	F
Margot	F
Bobby	F
Adelaide	F
Nan	F
Leeann	F
Elisha	F
Dessie	F
Libby	F
Kathi	F
Gayla	F
Latanya	F
Mina	F
Mellisa	F
Kimberlee	F
Jasmin	F
Renae	F
Zelda	F
Elda	F
Ma	F
Justina	F
Gussie	F
Emilie	F
Camilla	F
Abbie	F
Rocio	F
Kaitlyn	F
Jesse	F
Edythe	F
Ashleigh	F
Selina	F
Lakesha	F
Geri	F
Allene	F
Pamala	F
Michaela	F
Dayna	F
Caryn	F
Rosalia	F
Sun	F
Jacquline	F
Rebeca	F
Marybeth	F
Krystle	F
Iola	F
Dottie	F
Bennie	F
Belle	F
Aubrey	F
Griselda	F
Ernestina	F
Elida	F
Adrianne	F
Demetria	F
Delma	F
Chong	F
Jaqueline	F
Destiny	F
Arleen	F
Virgina	F
Retha	F
Fatima	F
Tillie	F
Eleanore	F
Cari	F
Treva	F
Birdie	F
Wilhelmina	F
Rosalee	F
Maurine	F
Latrice	F
Yong	F
Jena	F
Taryn	F
Elia	F
Debby	F
Maudie	F
Jeanna	F
Delilah	F
Catrina	F
Shonda	F
Hortencia	F
Theodora	F
Teresita	F
Robbin	F
Danette	F
Maryjane	F
Freddie	F
Delphine	F
Brianne	F
Nilda	F
Danna	F
Cindi	F
Bess	F
Iona	F
Hanna	F
Ariel	F
Winona	F
Vida	F
Rosita	F
Marianna	F
William	F
Racheal	F
Guillermina	F
Eloisa	F
Celestine	F
Caren	F
Malissa	F
Lona	F
Chantel	F
Shellie	F
Marisela	F
Leora	F
Agatha	F
Soledad	F
Migdalia	F
Ivette	F
Christen	F
Athena	F
Janel	F
Chloe	F
Veda	F
Pattie	F
Tessie	F
Tera	F
Marilynn	F
Lucretia	F
Karrie	F
Dinah	F
Daniela	F
Alecia	F
Adelina	F
Vernice	F
Shiela	F
Portia	F
Merry	F
Lashawn	F
Devon	F
Dara	F
Tawana	F
Oma	F
Verda	F
Christin	F
Alene	F
Zella	F
Sandi	F
Rafaela	F
Maya	F
Kira	F
Candida	F
Alvina	F
Suzan	F
Shayla	F
Lyn	F
Lettie	F
Alva	F
Samatha	F
Oralia	F
Matilde	F
Madonna	F
Larissa	F
Vesta	F
Renita	F
India	F
Delois	F
Shanda	F
Phillis	F
Lorri	F
Erlinda	F
Cruz	F
Cathrine	F
Barb	F
Zoe	F
Isabell	F
Ione	F
Gisela	F
Charlie	F
Valencia	F
Roxanna	F
Mayme	F
Kisha	F
Ellie	F
Mellissa	F
Dorris	F
Dalia	F
Bella	F
Annetta	F
Zoila	F
Reta	F
Reina	F
Lauretta	F
Kylie	F
Christal	F
Pilar	F
Charla	F
Elissa	F
Tiffani	F
Tana	F
Paulina	F
Leota	F
Breanna	F
Jayme	F
Carmel	F
Vernell	F
Tomasa	F
Mandi	F
Dominga	F
Santa	F
Melodie	F
Lura	F
Alexa	F
Tamela	F
Ryan	F
Mirna	F
Kerrie	F
Venus	F
Noel	F
Felicita	F
Cristy	F
Carmelita	F
Berniece	F
Annemarie	F
Tiara	F
Roseanne	F
Missy	F
Cori	F
Roxana	F
Pricilla	F
Kristal	F
Jung	F
Elyse	F
Haydee	F
Aletha	F
Bettina	F
Marge	F
Gillian	F
Filomena	F
Charles	F
Zenaida	F
Harriette	F
Caridad	F
Vada	F
Una	F
Aretha	F
Pearline	F
Marjory	F
Marcela	F
Flor	F
Evette	F
Elouise	F
Alina	F
Trinidad	F
David	F
Damaris	F
Catharine	F
Carroll	F
Belva	F
Nakia	F
Marlena	F
Luanne	F
Lorine	F
Karon	F
Dorene	F
Danita	F
Brenna	F
Tatiana	F
Sammie	F
Louann	F
Loren	F
Julianna	F
Andria	F
Philomena	F
Lucila	F
Leonora	F
Dovie	F
Romona	F
Mimi	F
Jacquelin	F
Gaye	F
Tonja	F
Misti	F
Joe	F
Gene	F
Chastity	F
Stacia	F
Roxann	F
Micaela	F
Nikita	F
Mei	F
Velda	F
Marlys	F
Johnna	F
Aura	F
Lavern	F
Ivonne	F
Hayley	F
Nicki	F
Majorie	F
Herlinda	F
George	F
Alpha	F
Yadira	F
Perla	F
Gregoria	F
Daniel	F
Antonette	F
Shelli	F
Mozelle	F
Mariah	F
Joelle	F
Cordelia	F
Josette	F
Chiquita	F
Trista	F
Louis	F
Laquita	F
Georgiana	F
Candi	F
Shanon	F
Lonnie	F
Hildegard	F
Cecil	F
Valentina	F
Stephany	F
Magda	F
Karol	F
Gerry	F
Gabriella	F
Tiana	F
Roma	F
Richelle	F
Ray	F
Princess	F
Oleta	F
Jacque	F
Idella	F
Alaina	F
Suzanna	F
Jovita	F
Blair	F
Tosha	F
Raven	F
Nereida	F
Marlyn	F
Kyla	F
Joseph	F
Delfina	F
Tena	F
Stephenie	F
Sabina	F
Nathalie	F
Marcelle	F
Gertie	F
Darleen	F
Thea	F
Sharonda	F
Shantel	F
Belen	F
Venessa	F
Rosalina	F
Ona	F
Genoveva	F
Corey	F
Clementine	F
Rosalba	F
Renate	F
Renata	F
Mi	F
Ivory	F
Georgianna	F
Floy	F
Dorcas	F
Ariana	F
Tyra	F
Theda	F
Mariam	F
Juli	F
Jesica	F
Donnie	F
Vikki	F
Verla	F
Roselyn	F
Melvina	F
Jannette	F
Ginny	F
Debrah	F
Corrie	F
Asia	F
Violeta	F
Myrtis	F
Latricia	F
Collette	F
Charleen	F
Anissa	F
Viviana	F
Twyla	F
Precious	F
Nedra	F
Latonia	F
Lan	F
Hellen	F
Fabiola	F
Annamarie	F
Adell	F
Sharyn	F
Chantal	F
Niki	F
Maud	F
Lizette	F
Lindy	F
Kia	F
Kesha	F
Jeana	F
Danelle	F
Charline	F
Chanel	F
Carrol	F
Valorie	F
Lia	F
Dortha	F
Cristal	F
Sunny	F
Leone	F
Leilani	F
Gerri	F
Debi	F
Andra	F
Keshia	F
Ima	F
Eulalia	F
Easter	F
Dulce	F
Natividad	F
Linnie	F
Kami	F
Georgie	F
Catina	F
Brook	F
Alda	F
Winnifred	F
Sharla	F
Ruthann	F
Meaghan	F
Magdalene	F
Lissette	F
Adelaida	F
Venita	F
Trena	F
Shirlene	F
Shameka	F
Elizebeth	F
Dian	F
Shanta	F
Mickey	F
Latosha	F
Carlotta	F
Windy	F
Soon	F
Rosina	F
Mariann	F
Leisa	F
Jonnie	F
Dawna	F
Cathie	F
Billy	F
Astrid	F
Sidney	F
Laureen	F
Janeen	F
Holli	F
Fawn	F
Vickey	F
Teressa	F
Shante	F
Rubye	F
Marcelina	F
Chanda	F
Cary	F
Terese	F
Scarlett	F
Marty	F
Marnie	F
Lulu	F
Lisette	F
Jeniffer	F
Elenor	F
Dorinda	F
Donita	F
Carman	F
Bernita	F
Altagracia	F
Aleta	F
Adrianna	F
Zoraida	F
Ronnie	F
Nicola	F
Lyndsey	F
Kendall	F
Janina	F
Chrissy	F
Ami	F
Starla	F
Phylis	F
Phuong	F
Kyra	F
Charisse	F
Blanch	F
Sanjuanita	F
Rona	F
Nanci	F
Marilee	F
Maranda	F
Cory	F
Brigette	F
Sanjuana	F
Marita	F
Kassandra	F
Joycelyn	F
Ira	F
Felipa	F
Chelsie	F
Bonny	F
Mireya	F
Lorenza	F
Kyong	F
Ileana	F
Candelaria	F
Tony	F
Toby	F
Sherie	F
Ok	F
Mark	F
Lucie	F
Leatrice	F
Lakeshia	F
Gerda	F
Edie	F
Bambi	F
Marylin	F
Lavon	F
Hortense	F
Garnet	F
Evie	F
Tressa	F
Shayna	F
Lavina	F
Kyung	F
Jeanetta	F
Sherrill	F
Shara	F
Phyliss	F
Mittie	F
Anabel	F
Alesia	F
Thuy	F
Tawanda	F
Richard	F
Joanie	F
Tiffanie	F
Lashanda	F
Karissa	F
Enriqueta	F
Daria	F
Daniella	F
Corinna	F
Alanna	F
Abbey	F
Roxane	F
Roseanna	F
Magnolia	F
Lida	F
Kyle	F
Joellen	F
Era	F
Coral	F
Carleen	F
Tresa	F
Peggie	F
Novella	F
Nila	F
Maybelle	F
Jenelle	F
Carina	F
Nova	F
Melina	F
Marquerite	F
Margarette	F
Josephina	F
Evonne	F
Devin	F
Cinthia	F
Albina	F
Toya	F
Tawnya	F
Sherita	F
Santos	F
Myriam	F
Lizabeth	F
Lise	F
Keely	F
Jenni	F
Giselle	F
Cheryle	F
Ardith	F
Ardis	F
Alesha	F
Adriane	F
Shaina	F
Linnea	F
Karolyn	F
Hong	F
Florida	F
Felisha	F
Dori	F
Darci	F
Artie	F
Armida	F
Zola	F
Xiomara	F
Vergie	F
Shamika	F
Nena	F
Nannette	F
Maxie	F
Lovie	F
Jeane	F
Jaimie	F
Inge	F
Farrah	F
Elaina	F
Caitlyn	F
Starr	F
Felicitas	F
Cherly	F
Caryl	F
Yolonda	F
Yasmin	F
Teena	F
Prudence	F
Pennie	F
Nydia	F
Mackenzie	F
Orpha	F
Marvel	F
Lizbeth	F
Laurette	F
Jerrie	F
Hermelinda	F
Carolee	F
Tierra	F
Mirian	F
Meta	F
Melony	F
Kori	F
Jennette	F
Jamila	F
Ena	F
Anh	F
Yoshiko	F
Susannah	F
Salina	F
Rhiannon	F
Joleen	F
Cristine	F
Ashton	F
Aracely	F
Tomeka	F
Shalonda	F
Marti	F
Lacie	F
Kala	F
Jada	F
Ilse	F
Hailey	F
Brittani	F
Zona	F
Syble	F
Sherryl	F
Randy	F
Nidia	F
Marlo	F
Kandice	F
Kandi	F
Deb	F
Dean	F
America	F
Alycia	F
Tommy	F
Ronna	F
Norene	F
Mercy	F
Jose	F
Ingeborg	F
Giovanna	F
Gemma	F
Christel	F
Audry	F
Zora	F
Vita	F
Van	F
Trish	F
Stephaine	F
Shirlee	F
Shanika	F
Melonie	F
Mazie	F
Jazmin	F
Inga	F
Hoa	F
Hettie	F
Geralyn	F
Fonda	F
Estrella	F
Adella	F
Su	F
Sarita	F
Rina	F
Milissa	F
Maribeth	F
Golda	F
Evon	F
Ethelyn	F
Enedina	F
Cherise	F
Chana	F
Velva	F
Tawanna	F
Sade	F
Mirta	F
Li	F
Karie	F
Jacinta	F
Elna	F
Davina	F
Cierra	F
Ashlie	F
Albertha	F
Tanesha	F
Stephani	F
Nelle	F
Mindi	F
Lu	F
Lorinda	F
Larue	F
Florene	F
Demetra	F
Dedra	F
Ciara	F
Chantelle	F
Ashly	F
Suzy	F
Rosalva	F
Noelia	F
Lyda	F
Leatha	F
Krystyna	F
Kristan	F
Karri	F
Darline	F
Darcie	F
Cinda	F
Cheyenne	F
Cherrie	F
Awilda	F
Almeda	F
Rolanda	F
Lanette	F
Jerilyn	F
Gisele	F
Evalyn	F
Cyndi	F
Cleta	F
Carin	F
Zina	F
Zena	F
Velia	F
Tanika	F
Paul	F
Charissa	F
Thomas	F
Talia	F
Margarete	F
Lavonda	F
Kaylee	F
Kathlene	F
Jonna	F
Irena	F
Ilona	F
Idalia	F
Candis	F
Candance	F
Brandee	F
Anitra	F
Alida	F
Sigrid	F
Nicolette	F
Maryjo	F
Linette	F
Hedwig	F
Christiana	F
Cassidy	F
Alexia	F
Tressie	F
Modesta	F
Lupita	F
Lita	F
Gladis	F
Evelia	F
Davida	F
Cherri	F
Cecily	F
Ashely	F
Annabel	F
Agustina	F
Wanita	F
Shirly	F
Rosaura	F
Hulda	F
Eun	F
Bailey	F
Yetta	F
Verona	F
Thomasina	F
Sibyl	F
Shannan	F
Mechelle	F
Lue	F
Leandra	F
Lani	F
Kylee	F
Kandy	F
Jolynn	F
Ferne	F
Eboni	F
Corene	F
Alysia	F
Zula	F
Nada	F
Moira	F
Lyndsay	F
Lorretta	F
Juan	F
Jammie	F
Hortensia	F
Gaynell	F
Cameron	F
Adria	F
Vina	F
Vicenta	F
Tangela	F
Stephine	F
Norine	F
Nella	F
Liana	F
Leslee	F
Kimberely	F
Iliana	F
Glory	F
Felica	F
Emogene	F
Elfriede	F
Eden	F
Eartha	F
Carma	F
Bea	F
Ocie	F
Marry	F
Lennie	F
Kiara	F
Jacalyn	F
Carlota	F
Arielle	F
Yu	F
Star	F
Otilia	F
Kirstin	F
Kacey	F
Johnetta	F
Joey	F
Joetta	F
Jeraldine	F
Jaunita	F
Elana	F
Dorthea	F
Cami	F
Amada	F
Adelia	F
Vernita	F
Tamar	F
Siobhan	F
Renea	F
Rashida	F
Ouida	F
Odell	F
Nilsa	F
Meryl	F
Kristyn	F
Julieta	F
Danica	F
Breanne	F
Aurea	F
Anglea	F
Sherron	F
Odette	F
Malia	F
Lorelei	F
Lin	F
Leesa	F
Kenna	F
Kathlyn	F
Fiona	F
Charlette	F
Suzie	F
Shantell	F
Sabra	F
Racquel	F
Myong	F
Mira	F
Martine	F
Lucienne	F
Lavada	F
Juliann	F
Johnie	F
Elvera	F
Delphia	F
Clair	F
Christiane	F
Charolette	F
Carri	F
Augustine	F
Asha	F
Angella	F
Paola	F
Ninfa	F
Leda	F
Lai	F
Eda	F
Sunshine	F
Stefani	F
Shanell	F
Palma	F
Machelle	F
Lissa	F
Kecia	F
Kathryne	F
Karlene	F
Julissa	F
Jettie	F
Jenniffer	F
Hui	F
Corrina	F
Christopher	F
Carolann	F
Alena	F
Tess	F
Rosaria	F
Myrtice	F
Marylee	F
Liane	F
Kenyatta	F
Judie	F
Janey	F
In	F
Elmira	F
Eldora	F
Denna	F
Cristi	F
Cathi	F
Zaida	F
Vonnie	F
Viva	F
Vernie	F
Rosaline	F
Mariela	F
Luciana	F
Lesli	F
Karan	F
Felice	F
Deneen	F
Adina	F
Wynona	F
Tarsha	F
Sheron	F
Shasta	F
Shanita	F
Shani	F
Shandra	F
Randa	F
Pinkie	F
Paris	F
Nelida	F
Marilou	F
Lyla	F
Laurene	F
Laci	F
Joi	F
Janene	F
Dorotha	F
Daniele	F
Dani	F
Carolynn	F
Carlyn	F
Berenice	F
Ayesha	F
Anneliese	F
Alethea	F
Thersa	F
Tamiko	F
Rufina	F
Oliva	F
Mozell	F
Marylyn	F
Madison	F
Kristian	F
Kathyrn	F
Kasandra	F
Kandace	F
Janae	F
Gabriel	F
Domenica	F
Debbra	F
Dannielle	F
Chun	F
Buffy	F
Barbie	F
Arcelia	F
Aja	F
Zenobia	F
Sharen	F
Sharee	F
Patrick	F
Page	F
My	F
Lavinia	F
Kum	F
Kacie	F
Jackeline	F
Huong	F
Felisa	F
Emelia	F
Eleanora	F
Cythia	F
Cristin	F
Clyde	F
Claribel	F
Caron	F
Anastacia	F
Zulma	F
Zandra	F
Yoko	F
Tenisha	F
Susann	F
Sherilyn	F
Shay	F
Shawanda	F
Sabine	F
Romana	F
Mathilda	F
Linsey	F
Keiko	F
Joana	F
Isela	F
Gretta	F
Georgetta	F
Eugenie	F
Dusty	F
Desirae	F
Delora	F
Corazon	F
Antonina	F
Anika	F
Willene	F
Tracee	F
Tamatha	F
Regan	F
Nichelle	F
Mickie	F
Maegan	F
Luana	F
Lanita	F
Kelsie	F
Edelmira	F
Bree	F
Afton	F
Teodora	F
Tamie	F
Shena	F
Meg	F
Linh	F
Keli	F
Kaci	F
Danyelle	F
Britt	F
Arlette	F
Albertine	F
Adelle	F
Tiffiny	F
Stormy	F
Simona	F
Numbers	F
Nicolasa	F
Nichol	F
Nia	F
Nakisha	F
Mee	F
Maira	F
Loreen	F
Kizzy	F
Johnny	F
Jay	F
Fallon	F
Christene	F
Bobbye	F
Anthony	F
Ying	F
Vincenza	F
Tanja	F
Rubie	F
Roni	F
Queenie	F
Margarett	F
Kimberli	F
Irmgard	F
Idell	F
Hilma	F
Evelina	F
Esta	F
Emilee	F
Dennise	F
Dania	F
Carl	F
Carie	F
Antonio	F
Wai	F
Sang	F
Risa	F
Rikki	F
Particia	F
Mui	F
Masako	F
Mario	F
Luvenia	F
Loree	F
Loni	F
Lien	F
Kevin	F
Gigi	F
Florencia	F
Dorian	F
Denita	F
Dallas	F
Chi	F
Billye	F
Alexander	F
Tomika	F
Sharita	F
Rana	F
Nikole	F
Neoma	F
Margarite	F
Madalyn	F
Lucina	F
Laila	F
Kali	F
Jenette	F
Gabriele	F
Evelyne	F
Elenora	F
Clementina	F
Alejandrina	F
Zulema	F
Violette	F
Vannessa	F
Thresa	F
Retta	F
Pia	F
Patience	F
Noella	F
Nickie	F
Jonell	F
Delta	F
Chung	F
Chaya	F
Camelia	F
Bethel	F
Anya	F
Andrew	F
Thanh	F
Suzann	F
Spring	F
Shu	F
Mila	F
Lilla	F
Laverna	F
Keesha	F
Kattie	F
Gia	F
Georgene	F
Eveline	F
Estell	F
Elizbeth	F
Vivienne	F
Vallie	F
Trudie	F
Stephane	F
Michel	F
Magaly	F
Madie	F
Kenyetta	F
Karren	F
Janetta	F
Hermine	F
Harmony	F
Drucilla	F
Debbi	F
Celestina	F
Candie	F
Britni	F
Beckie	F
Amina	F
Zita	F
Yun	F
Yolande	F
Vivien	F
Vernetta	F
Trudi	F
Sommer	F
Pearle	F
Patrina	F
Ossie	F
Nicolle	F
Loyce	F
Letty	F
Larisa	F
Katharina	F
Joselyn	F
Jonelle	F
Jenell	F
Iesha	F
Heide	F
Florinda	F
Florentina	F
Flo	F
Elodia	F
Dorine	F
Brunilda	F
Brigid	F
Ashli	F
Ardella	F
Twana	F
Thu	F
Tarah	F
Sung	F
Shea	F
Shavon	F
Shane	F
Serina	F
Rayna	F
Ramonita	F
Nga	F
Margurite	F
Lucrecia	F
Kourtney	F
Kati	F
Jesus	F
Jesenia	F
Diamond	F
Crista	F
Ayana	F
Alica	F
Alia	F
Vinnie	F
Suellen	F
Romelia	F
Rachell	F
Piper	F
Olympia	F
Michiko	F
Kathaleen	F
Jolie	F
Jessi	F
Janessa	F
Hana	F
Ha	F
Elease	F
Carletta	F
Britany	F
Shona	F
Salome	F
Rosamond	F
Regena	F
Raina	F
Ngoc	F
Nelia	F
Louvenia	F
Lesia	F
Latrina	F
Laticia	F
Larhonda	F
Jina	F
Jacki	F
Hollis	F
Holley	F
Emmy	F
Deeann	F
Coretta	F
Arnetta	F
Velvet	F
Thalia	F
Shanice	F
Neta	F
Mikki	F
Micki	F
Lonna	F
Leana	F
Lashunda	F
Kiley	F
Joye	F
Jacqulyn	F
Ignacia	F
Hyun	F
Hiroko	F
Henry	F
Henriette	F
Elayne	F
Delinda	F
Darnell	F
Dahlia	F
Coreen	F
Consuela	F
Conchita	F
Celine	F
Babette	F
Ayanna	F
Anette	F
Albertina	F
Skye	F
Shawnee	F
Shaneka	F
Quiana	F
Pamelia	F
Min	F
Merri	F
Merlene	F
Margit	F
Kiesha	F
Kiera	F
Kaylene	F
Jodee	F
Jenise	F
Erlene	F
Emmie	F
Else	F
Daryl	F
Dalila	F
Daisey	F
Cody	F
Casie	F
Belia	F
Babara	F
Versie	F
Vanesa	F
Shelba	F
Shawnda	F
Sam	F
Norman	F
Nikia	F
Naoma	F
Marna	F
Margeret	F
Madaline	F
Lawana	F
Kindra	F
Jutta	F
Jazmine	F
Janett	F
Hannelore	F
Glendora	F
Gertrud	F
Garnett	F
Freeda	F
Frederica	F
Florance	F
Flavia	F
Dennis	F
Carline	F
Beverlee	F
Anjanette	F
Valda	F
Trinity	F
Tamala	F
Stevie	F
Shonna	F
Sha	F
Sarina	F
Oneida	F
Micah	F
Merilyn	F
Marleen	F
Lurline	F
Lenna	F
Katherin	F
Jin	F
Jeni	F
Hae	F
Gracia	F
Glady	F
Farah	F
Eric	F
Enola	F
Ema	F
Dominque	F
Devona	F
Delana	F
Cecila	F
Caprice	F
Alysha	F
Ali	F
Alethia	F
Vena	F
Theresia	F
Tawny	F
Song	F
Shakira	F
Samara	F
Sachiko	F
Rachele	F
Pamella	F
Nicky	F
Marni	F
Mariel	F
Maren	F
Malisa	F
Ligia	F
Lera	F
Latoria	F
Larae	F
Kimber	F
Kathern	F
Karey	F
Jennefer	F
Janeth	F
Halina	F
Fredia	F
Delisa	F
Debroah	F
Ciera	F
Chin	F
Angelika	F
Andree	F
Altha	F
Yen	F
Vivan	F
Terresa	F
Tanna	F
Suk	F
Sudie	F
Soo	F
Signe	F
Salena	F
Ronni	F
Rebbecca	F
Myrtie	F
Mckenzie	F
Malika	F
Maida	F
Loan	F
Leonarda	F
Kayleigh	F
France	F
Ethyl	F
Ellyn	F
Dayle	F
Cammie	F
Brittni	F
Birgit	F
Avelina	F
Asuncion	F
Arianna	F
Akiko	F
Venice	F
Tyesha	F
Tonie	F
Tiesha	F
Takisha	F
Steffanie	F
Sindy	F
Santana	F
Meghann	F
Manda	F
Macie	F
Lady	F
Kellye	F
Kellee	F
Joslyn	F
Jason	F
Inger	F
Indira	F
Glinda	F
Glennis	F
Fernanda	F
Faustina	F
Eneida	F
Elicia	F
Dot	F
Digna	F
Dell	F
Arletta	F
Andre	F
Willia	F
Tammara	F
Tabetha	F
Sherrell	F
Sari	F
Refugio	F
Rebbeca	F
Pauletta	F
Nieves	F
Natosha	F
Nakita	F
Mammie	F
Kenisha	F
Kazuko	F
Kassie	F
Gary	F
Earlean	F
Daphine	F
Corliss	F
Clotilde	F
Carolyne	F
Bernetta	F
Augustina	F
Audrea	F
Annis	F
Annabell	F
Yan	F
Tennille	F
Tamica	F
Selene	F
Sean	F
Rosana	F
Regenia	F
Qiana	F
Markita	F
Macy	F
Leeanne	F
Laurine	F
Kym	F
Jessenia	F
Janita	F
Georgine	F
Genie	F
Emiko	F
Elvie	F
Deandra	F
Dagmar	F
Corie	F
Collen	F
Cherish	F
Romaine	F
Porsha	F
Pearlene	F
Micheline	F
Merna	F
Margorie	F
Margaretta	F
Lore	F
Kenneth	F
Jenine	F
Hermina	F
Fredericka	F
Elke	F
Drusilla	F
Dorathy	F
Dione	F
Desire	F
Celena	F
Brigida	F
Angeles	F
Allegra	F
Theo	F
Tamekia	F
Synthia	F
Stephen	F
Sook	F
Slyvia	F
Rosann	F
Reatha	F
Raye	F
Marquetta	F
Margart	F
Ling	F
Layla	F
Kymberly	F
Kiana	F
Kayleen	F
Katlyn	F
Karmen	F
Joella	F
Irina	F
Emelda	F
Eleni	F
Detra	F
Clemmie	F
Cheryll	F
Chantell	F
Cathey	F
Arnita	F
Arla	F
Angle	F
Angelic	F
Alyse	F
Zofia	F
Thomasine	F
Tennie	F
Son	F
Sherly	F
Sherley	F
Sharyl	F
Remedios	F
Petrina	F
Nickole	F
Myung	F
Myrle	F
Mozella	F
Louanne	F
Lisha	F
Latia	F
Lane	F
Krysta	F
Julienne	F
Joel	F
Jeanene	F
Jacqualine	F
Isaura	F
Gwenda	F
Earleen	F
Donald	F
Cleopatra	F
Carlie	F
Audie	F
Antonietta	F
Alise	F
Alex	F
Verdell	F
Val	F
Tyler	F
Tomoko	F
Thao	F
Talisha	F
Steven	F
So	F
Shemika	F
Shaun	F
Scarlet	F
Savanna	F
Santina	F
Rosia	F
Raeann	F
Odilia	F
Nana	F
Minna	F
Magan	F
Lynelle	F
Le	F
Karma	F
Joeann	F
Ivana	F
Inell	F
Ilana	F
Hye	F
Honey	F
Hee	F
Gudrun	F
Frank	F
Dreama	F
Crissy	F
Chante	F
Carmelina	F
Arvilla	F
Arthur	F
Annamae	F
Alvera	F
Aleida	F
Aaron	F
Yee	F
Yanira	F
Vanda	F
Tianna	F
Tam	F
Stefania	F
Shira	F
Perry	F
Nicol	F
Nancie	F
Monserrate	F
Minh	F
Melynda	F
Melany	F
Matthew	F
Lovella	F
Laure	F
Kirby	F
Kacy	F
Jacquelynn	F
Hyon	F
Gertha	F
Francisco	F
Eliana	F
Christena	F
Christeen	F
Charise	F
Caterina	F
Carley	F
Candyce	F
Arlena	F
Ammie	F
Yang	F
Willette	F
Vanita	F
Tuyet	F
Tiny	F
Syreeta	F
Silva	F
Scott	F
Ronald	F
Penney	F
Nyla	F
Michal	F
Maurice	F
Maryam	F
Marya	F
Magen	F
Ludie	F
Loma	F
Livia	F
Lanell	F
Kimberlie	F
Julee	F
Donetta	F
Diedra	F
Denisha	F
Deane	F
Dawne	F
Clarine	F
Cherryl	F
Bronwyn	F
Brandon	F
Alla	F
Valery	F
Tonda	F
Sueann	F
Soraya	F
Shoshana	F
Shela	F
Sharleen	F
Shanelle	F
Nerissa	F
Micheal	F
Meridith	F
Mellie	F
Maye	F
Maple	F
Magaret	F
Luis	F
Lili	F
Leonila	F
Leonie	F
Leeanna	F
Lavonia	F
Lavera	F
Kristel	F
Kathey	F
Kathe	F
Justin	F
Julian	F
Jimmy	F
Jann	F
Ilda	F
Hildred	F
Hildegarde	F
Genia	F
Fumiko	F
Evelin	F
Ermelinda	F
Elly	F
Dung	F
Doloris	F
Dionna	F
Danae	F
Berneice	F
Annice	F
Alix	F
Verena	F
Verdie	F
Tristan	F
Shawnna	F
Shawana	F
Shaunna	F
Rozella	F
Randee	F
Ranae	F
Milagro	F
Lynell	F
Luise	F
Louie	F
Loida	F
Lisbeth	F
Karleen	F
Junita	F
Jona	F
Isis	F
Hyacinth	F
Hedy	F
Gwenn	F
Ethelene	F
Erline	F
Edward	F
Donya	F
Domonique	F
Delicia	F
Dannette	F
Cicely	F
Branda	F
Blythe	F
Bethann	F
Ashlyn	F
Annalee	F
Alline	F
Yuko	F
Vella	F
Trang	F
Towanda	F
Tesha	F
Sherlyn	F
Narcisa	F
Miguelina	F
Meri	F
Maybell	F
Marlana	F
Marguerita	F
Madlyn	F
Luna	F
Lory	F
Loriann	F
Liberty	F
Leonore	F
Leighann	F
Laurice	F
Latesha	F
Laronda	F
Katrice	F
Kasie	F
Karl	F
Kaley	F
Jadwiga	F
Glennie	F
Gearldine	F
Francina	F
Epifania	F
Dyan	F
Dorie	F
Diedre	F
Denese	F
Demetrice	F
Delena	F
Darby	F
Cristie	F
Cleora	F
Catarina	F
Carisa	F
Bernie	F
Barbera	F
Almeta	F
Trula	F
Tereasa	F
Solange	F
Sheilah	F
Shavonne	F
Sanora	F
Rochell	F
Mathilde	F
Margareta	F
Maia	F
Lynsey	F
Lawanna	F
Launa	F
Kena	F
Keena	F
Katia	F
Jamey	F
Glynda	F
Gaylene	F
Elvina	F
Elanor	F
Danuta	F
Danika	F
Cristen	F
Cordie	F
Coletta	F
Clarita	F
Carmon	F
Brynn	F
Azucena	F
Aundrea	F
Angele	F
Yi	F
Walter	F
Verlie	F
Verlene	F
Tamesha	F
Silvana	F
Sebrina	F
Samira	F
Reda	F
Raylene	F
Penni	F
Pandora	F
Norah	F
Noma	F
Mireille	F
Melissia	F
Maryalice	F
Laraine	F
Kimbery	F
Karyl	F
Karine	F
Kam	F
Jolanda	F
Johana	F
Jesusa	F
Jaleesa	F
Jae	F
Jacquelyne	F
Irish	F
Iluminada	F
Hilaria	F
Hanh	F
Gennie	F
Francie	F
Floretta	F
Exie	F
Edda	F
Drema	F
Delpha	F
Bev	F
Barbar	F
Assunta	F
Ardell	F
Annalisa	F
Alisia	F
Yukiko	F
Yolando	F
Wonda	F
Wei	F
Waltraud	F
Veta	F
Tequila	F
Temeka	F
Tameika	F
Shirleen	F
Shenita	F
Piedad	F
Ozella	F
Mirtha	F
Marilu	F
Kimiko	F
Juliane	F
Jenice	F
Jen	F
Janay	F
Jacquiline	F
Hilde	F
Fe	F
Fae	F
Evan	F
Eugene	F
Elois	F
Echo	F
Devorah	F
Chau	F
Brinda	F
Betsey	F
Arminda	F
Aracelis	F
Apryl	F
Annett	F
Alishia	F
Veola	F
Usha	F
Toshiko	F
Theola	F
Tashia	F
Talitha	F
Shery	F
Rudy	F
Renetta	F
Reiko	F
Rasheeda	F
Omega	F
Obdulia	F
Mika	F
Melaine	F
Meggan	F
Martin	F
Marlen	F
Marget	F
Marceline	F
Mana	F
Magdalen	F
Librada	F
Lezlie	F
Lexie	F
Latashia	F
Lasandra	F
Kelle	F
Isidra	F
Isa	F
Inocencia	F
Gwyn	F
Francoise	F
Erminia	F
Erinn	F
Dimple	F
Devora	F
Criselda	F
Armanda	F
Arie	F
Ariane	F
Angelo	F
Angelena	F
Allen	F
Aliza	F
Adriene	F
Adaline	F
Xochitl	F
Twanna	F
Tran	F
Tomiko	F
Tamisha	F
Taisha	F
Susy	F
Siu	F
Rutha	F
Roxy	F
Rhona	F
Raymond	F
Otha	F
Noriko	F
Natashia	F
Merrie	F
Melvin	F
Marinda	F
Mariko	F
Margert	F
Loris	F
Lizzette	F
Leisha	F
Kaila	F
Ka	F
Joannie	F
Jerrica	F
Jene	F
Jannet	F
Janee	F
Jacinda	F
Herta	F
Elenore	F
Doretta	F
Delaine	F
Daniell	F
Claudie	F
China	F
Britta	F
Apolonia	F
Amberly	F
Alease	F
Yuri	F
Yuk	F
Wen	F
Waneta	F
Ute	F
Tomi	F
Sharri	F
Sandie	F
Roselle	F
Reynalda	F
Raguel	F
Phylicia	F
Patria	F
Olimpia	F
Odelia	F
Mitzie	F
Mitchell	F
Miss	F
Minda	F
Mignon	F
Mica	F
Mendy	F
Marivel	F
Maile	F
Lynetta	F
Lavette	F
Lauryn	F
Latrisha	F
Lakiesha	F
Kiersten	F
Kary	F
Josphine	F
Jolyn	F
Jetta	F
Janise	F
Jacquie	F
Ivelisse	F
Glynis	F
Gianna	F
Gaynelle	F
Emerald	F
Demetrius	F
Danyell	F
Danille	F
Dacia	F
Coralee	F
Cher	F
Ceola	F
Brett	F
Bell	F
Arianne	F
Aleshia	F
Yung	F
Williemae	F
Troy	F
Trinh	F
Thora	F
Tai	F
Svetlana	F
Sherika	F
Shemeka	F
Shaunda	F
Roseline	F
Ricki	F
Melda	F
Mallie	F
Lavonna	F
Latina	F
Larry	F
Laquanda	F
Lala	F
Lachelle	F
Klara	F
Kandis	F
Johna	F
Jeanmarie	F
Jaye	F
Hang	F
Grayce	F
Gertude	F
Emerita	F
Ebonie	F
Clorinda	F
Ching	F
Chery	F
Carola	F
Breann	F
Blossom	F
Bernardine	F
Becki	F
Arletha	F
Argelia	F
Ara	F
Alita	F
Yulanda	F
Yon	F
Yessenia	F
Tobi	F
Tasia	F
Sylvie	F
Shirl	F
Shirely	F
Sheridan	F
Shella	F
Shantelle	F
Sacha	F
Royce	F
Rebecka	F
Reagan	F
Providencia	F
Paulene	F
Misha	F
Miki	F
Marline	F
Marica	F
Lorita	F
Latoyia	F
Lasonya	F
Kerstin	F
Kenda	F
Keitha	F
Kathrin	F
Jaymie	F
Jack	F
Gricelda	F
Ginette	F
Eryn	F
Elina	F
Elfrieda	F
Danyel	F
Cheree	F
Chanelle	F
Barrie	F
Avery	F
Aurore	F
Annamaria	F
Alleen	F
Ailene	F
Aide	F
Yasmine	F
Vashti	F
Valentine	F
Treasa	F
Tory	F
Tiffaney	F
Sheryll	F
Sharie	F
Shanae	F
Sau	F
Raisa	F
Pa	F
Neda	F
Mitsuko	F
Mirella	F
Milda	F
Maryanna	F
Maragret	F
Mabelle	F
Luetta	F
Lorina	F
Letisha	F
Latarsha	F
Lanelle	F
Lajuana	F
Krissy	F
Karly	F
Karena	F
Jon	F
Jessika	F
Jerica	F
Jeanelle	F
January	F
Jalisa	F
Jacelyn	F
Izola	F
Ivey	F
Gregory	F
Euna	F
Etha	F
Drew	F
Domitila	F
Dominica	F
Daina	F
Creola	F
Carli	F
Camie	F
Bunny	F
Brittny	F
Ashanti	F
Anisha	F
Aleen	F
Adah	F
Yasuko	F
Winter	F
Viki	F
Valrie	F
Tona	F
Tinisha	F
Thi	F
Terisa	F
Tatum	F
Taneka	F
Simonne	F
Shalanda	F
Serita	F
Ressie	F
Refugia	F
Paz	F
Olene	F
Na	F
Merrill	F
Margherita	F
Mandie	F
Man	F
Maire	F
Lyndia	F
Luci	F
Lorriane	F
Loreta	F
Leonia	F
Lavona	F
Lashawnda	F
Lakia	F
Kyoko	F
Krystina	F
Krysten	F
Kenia	F
Kelsi	F
Jude	F
Jeanice	F
Isobel	F
Georgiann	F
Genny	F
Felicidad	F
Eilene	F
Deon	F
Deloise	F
Deedee	F
Dannie	F
Conception	F
Clora	F
Cherilyn	F
Chang	F
Calandra	F
Berry	F
Armandina	F
Anisa	F
Ula	F
Timothy	F
Tiera	F
Theressa	F
Stephania	F
Sima	F
Shyla	F
Shonta	F
Shera	F
Shaquita	F
Shala	F
Sammy	F
Rossana	F
Nohemi	F
Nery	F
Moriah	F
Melita	F
Melida	F
Melani	F
Marylynn	F
Marisha	F
Mariette	F
Malorie	F
Madelene	F
Ludivina	F
Loria	F
Lorette	F
Loralee	F
Lianne	F
Leon	F
Lavenia	F
Laurinda	F
Lashon	F
Kit	F
Kimi	F
Keila	F
Katelynn	F
Kai	F
Jone	F
Joane	F
Ji	F
Jayna	F
Janella	F
Ja	F
Hue	F
Hertha	F
Francene	F
Elinore	F
Despina	F
Delsie	F
Deedra	F
Clemencia	F
Carry	F
Carolin	F
Carlos	F
Bulah	F
Brittanie	F
Bok	F
Blondell	F
Bibi	F
Beaulah	F
Beata	F
Annita	F
Agripina	F
Virgen	F
Valene	F
Un	F
Twanda	F
Tommye	F
Toi	F
Tarra	F
Tari	F
Tammera	F
Shakia	F
Sadye	F
Ruthanne	F
Rochel	F
Rivka	F
Pura	F
Nenita	F
Natisha	F
Ming	F
Merrilee	F
Melodee	F
Marvis	F
Lucilla	F
Leena	F
Laveta	F
Larita	F
Lanie	F
Keren	F
Ileen	F
Georgeann	F
Genna	F
Genesis	F
Frida	F
Ewa	F
Eufemia	F
Emely	F
Ela	F
Edyth	F
Deonna	F
Deadra	F
Darlena	F
Chanell	F
Chan	F
Cathern	F
Cassondra	F
Cassaundra	F
Bernarda	F
Berna	F
Arlinda	F
Anamaria	F
Albert	F
Wesley	F
Vertie	F
Valeri	F
Torri	F
Tatyana	F
Stasia	F
Sherise	F
Sherill	F
Season	F
Scottie	F
Sanda	F
Ruthe	F
Rosy	F
Roberto	F
Robbi	F
Ranee	F
Quyen	F
Pearly	F
Palmira	F
Onita	F
Nisha	F
Niesha	F
Nida	F
Nevada	F
Nam	F
Merlyn	F
Mayola	F
Marylouise	F
Maryland	F
Marx	F
Marth	F
Margene	F
Madelaine	F
Londa	F
Leontine	F
Leoma	F
Leia	F
Lawrence	F
Lauralee	F
Lanora	F
Lakita	F
Kiyoko	F
Keturah	F
Katelin	F
Kareen	F
Jonie	F
Johnette	F
Jenee	F
Jeanett	F
Izetta	F
Hiedi	F
Heike	F
Hassie	F
Harold	F
Giuseppina	F
Georgann	F
Fidela	F
Fernande	F
Elwanda	F
Ellamae	F
Eliz	F
Dusti	F
Dotty	F
Cyndy	F
Coralie	F
Celesta	F
Argentina	F
Alverta	F
Xenia	F
Wava	F
Vanetta	F
Torrie	F
Tashina	F
Tandy	F
Tambra	F
Tama	F
Stepanie	F
Shila	F
Shaunta	F
Sharan	F
Shaniqua	F
Shae	F
Setsuko	F
Serafina	F
Sandee	F
Rosamaria	F
Priscila	F
Olinda	F
Nadene	F
Muoi	F
Michelina	F
Mercedez	F
Maryrose	F
Marin	F
Marcene	F
Mao	F
Magali	F
Mafalda	F
Logan	F
Linn	F
Lannie	F
Kayce	F
Karoline	F
Kamilah	F
Kamala	F
Justa	F
Joline	F
Jennine	F
Jacquetta	F
Iraida	F
Gerald	F
Georgeanna	F
Franchesca	F
Fairy	F
Emeline	F
Elane	F
Ehtel	F
Earlie	F
Dulcie	F
Dalene	F
Cris	F
Classie	F
Chere	F
Charis	F
Caroyln	F
Carmina	F
Carita	F
Brian	F
Bethanie	F
Ayako	F
Arica	F
An	F
Alysa	F
Alessandra	F
Akilah	F
Adrien	F
Zetta	F
Youlanda	F
Yelena	F
Yahaira	F
Xuan	F
Wendolyn	F
Victor	F
Tijuana	F
Terrell	F
Terina	F
Teresia	F
Suzi	F
Sunday	F
Sherell	F
Shavonda	F
Shaunte	F
Sharda	F
Shakita	F
Sena	F
Ryann	F
Rubi	F
Riva	F
Reginia	F
Rea	F
Rachal	F
Parthenia	F
Pamula	F
Monnie	F
Monet	F
Michaele	F
Melia	F
Marine	F
Malka	F
Maisha	F
Lisandra	F
Leo	F
Lekisha	F
Lean	F
Laurence	F
Lakendra	F
Krystin	F
Kortney	F
Kizzie	F
Kittie	F
Kera	F
Kendal	F
Kemberly	F
Kanisha	F
Julene	F
Jule	F
Joshua	F
Johanne	F
Jeffrey	F
Jamee	F
Han	F
Halley	F
Gidget	F
Galina	F
Fredricka	F
Fleta	F
Fatimah	F
Eusebia	F
Elza	F
Eleonore	F
Dorthey	F
Doria	F
Donella	F
Dinorah	F
Delorse	F
Claretha	F
Christinia	F
Charlyn	F
Bong	F
Belkis	F
Azzie	F
Andera	F
Aiko	F
Adena	F
Yer	F
Yajaira	F
Wan	F
Vania	F
Ulrike	F
Toshia	F
Tifany	F
Stefany	F
Shizue	F
Shenika	F
Shawanna	F
Sharolyn	F
Sharilyn	F
Shaquana	F
Shantay	F
See	F
Rozanne	F
Roselee	F
Rickie	F
Remona	F
Reanna	F
Raelene	F
Quinn	F
Phung	F
Petronila	F
Natacha	F
Nancey	F
Myrl	F
Miyoko	F
Miesha	F
Merideth	F
Marvella	F
Marquitta	F
Marhta	F
Marchelle	F
Lizeth	F
Libbie	F
Lahoma	F
Ladawn	F
Kina	F
Katheleen	F
Katharyn	F
Karisa	F
Kaleigh	F
Junie	F
Julieann	F
Johnsie	F
Janean	F
Jaimee	F
Jackqueline	F
Hisako	F
Herma	F
Helaine	F
Gwyneth	F
Glenn	F
Gita	F
Eustolia	F
Emelina	F
Elin	F
Edris	F
Donnette	F
Donnetta	F
Dierdre	F
Denae	F
Darcel	F
Claude	F
Clarisa	F
Cinderella	F
Chia	F
Charlesetta	F
Charita	F
Celsa	F
Cassy	F
Cassi	F
Carlee	F
Bruna	F
Brittaney	F
Brande	F
Billi	F
Bao	F
Antonetta	F
Angla	F
Angelyn	F
Analisa	F
Alane	F
Wenona	F
Wendie	F
Veronique	F
Vannesa	F
Tobie	F
Tempie	F
Sumiko	F
Sulema	F
Sparkle	F
Somer	F
Sheba	F
Shayne	F
Sharice	F
Shanel	F
Shalon	F
Sage	F
Roy	F
Rosio	F
Roselia	F
Renay	F
Rema	F
Reena	F
Porsche	F
Ping	F
Peg	F
Ozie	F
Oretha	F
Oralee	F
Oda	F
Nu	F
Ngan	F
Nakesha	F
Milly	F
Marybelle	F
Marlin	F
Maris	F
Margrett	F
Maragaret	F
Manie	F
Lurlene	F
Lillia	F
Lieselotte	F
Lavelle	F
Lashaunda	F
Lakeesha	F
Keith	F
Kaycee	F
Kalyn	F
Joya	F
Joette	F
Jenae	F
Janiece	F
Illa	F
Grisel	F
Glayds	F
Genevie	F
Gala	F
Fredda	F
Fred	F
Elmer	F
Eleonor	F
Debera	F
Deandrea	F
Dan	F
Corrinne	F
Cordia	F
Contessa	F
Colene	F
Cleotilde	F
Charlott	F
Chantay	F
Cecille	F
Beatris	F
Azalee	F
Arlean	F
Ardath	F
Anjelica	F
Anja	F
Alfredia	F
Aleisha	F
Adam	F
Zada	F
Yuonne	F
Xiao	F
Willodean	F
Whitley	F
Vennie	F
Vanna	F
Tyisha	F
Tova	F
Torie	F
Tonisha	F
Tilda	F
Tien	F
Temple	F
Sirena	F
Sherril	F
Shanti	F
Shan	F
Senaida	F
Samella	F
Robbyn	F
Renda	F
Reita	F
Phebe	F
Paulita	F
Nobuko	F
Nguyet	F
Neomi	F
Moon	F
Mikaela	F
Melania	F
Maximina	F
Marg	F
Maisie	F
Lynna	F
Lilli	F
Layne	F
Lashaun	F
Lakenya	F
Lael	F
Kirstie	F
Kathline	F
Kasha	F
Karlyn	F
Karima	F
Jovan	F
Josefine	F
Jennell	F
Jacqui	F
Jackelyn	F
Hyo	F
Hien	F
Grazyna	F
Florrie	F
Floria	F
Eleonora	F
Dwana	F
Dorla	F
Dong	F
Delmy	F
Deja	F
Dede	F
Dann	F
Crysta	F
Clelia	F
Claris	F
Clarence	F
Chieko	F
Cherlyn	F
Cherelle	F
Charmain	F
Chara	F
Cammy	F
Bee	F
Arnette	F
Ardelle	F
Annika	F
Amiee	F
Amee	F
Allena	F
Yvone	F
Yuki	F
Yoshie	F
Yevette	F
Yael	F
Willetta	F
Voncile	F
Venetta	F
Tula	F
Tonette	F
Timika	F
Temika	F
Telma	F
Teisha	F
Taren	F
Ta	F
Stacee	F
Shin	F
Shawnta	F
Saturnina	F
Ricarda	F
Pok	F
Pasty	F
Onie	F
Nubia	F
Mora	F
Mike	F
Marielle	F
Mariella	F
Marianela	F
Mardell	F
Many	F
Luanna	F
Loise	F
Lisabeth	F
Lindsy	F
Lilliana	F
Lilliam	F
Lelah	F
Leigha	F
Leanora	F
Lang	F
Kristeen	F
Khalilah	F
Keeley	F
Kandra	F
Junko	F
Joaquina	F
Jerlene	F
Jani	F
Jamika	F
Jame	F
Hsiu	F
Hermila	F
Golden	F
Genevive	F
Evia	F
Eugena	F
Emmaline	F
Elfreda	F
Elene	F
Donette	F
Delcie	F
Deeanna	F
Darcey	F
Cuc	F
Clarinda	F
Cira	F
Chae	F
Celinda	F
Catheryn	F
Catherin	F
Casimira	F
Carmelia	F
Camellia	F
Breana	F
Bobette	F
Bernardina	F
Bebe	F
Basilia	F
Arlyne	F
Amal	F
Alayna	F
Zonia	F
Zenia	F
Yuriko	F
Yaeko	F
Wynell	F
Willow	F
Willena	F
Vernia	F
Tu	F
Travis	F
Tora	F
Terrilyn	F
Terica	F
Tenesha	F
Tawna	F
Tajuana	F
Taina	F
Stephnie	F
Sona	F
Sol	F
Sina	F
Shondra	F
Shizuko	F
Sherlene	F
Sherice	F
Sharika	F
Rossie	F
Rosena	F
Rory	F
Rima	F
Ria	F
Rheba	F
Renna	F
Peter	F
Natalya	F
Nancee	F
Melodi	F
Meda	F
Maxima	F
Matha	F
Marketta	F
Maricruz	F
Marcelene	F
Malvina	F
Luba	F
Louetta	F
Leida	F
Lecia	F
Lauran	F
Lashawna	F
Laine	F
Khadijah	F
Katerine	F
Kasi	F
Kallie	F
Julietta	F
Jesusita	F
Jestine	F
Jessia	F
Jeremy	F
Jeffie	F
Janyce	F
Isadora	F
Georgianne	F
Fidelia	F
Evita	F
Eura	F
Eulah	F
Estefana	F
Elsy	F
Elizabet	F
Eladia	F
Dodie	F
Dion	F
Dia	F
Denisse	F
Deloras	F
Delila	F
Daysi	F
Dakota	F
Curtis	F
Crystle	F
Concha	F
Colby	F
Claretta	F
Chu	F
Christia	F
Charlsie	F
Charlena	F
Carylon	F
Bettyann	F
Asley	F
Ashlea	F
Amira	F
Ai	F
Agueda	F
Agnus	F
Yuette	F
Vinita	F
Victorina	F
Tynisha	F
Treena	F
Toccara	F
Tish	F
Thomasena	F
Tegan	F
Soila	F
Shiloh	F
Shenna	F
Sharmaine	F
Shantae	F
Shandi	F
September	F
Saran	F
Sarai	F
Sana	F
Samuel	F
Salley	F
Rosette	F
Rolande	F
Regine	F
Otelia	F
Oscar	F
Olevia	F
Nicholle	F
Necole	F
Naida	F
Myrta	F
Myesha	F
Mitsue	F
Minta	F
Mertie	F
Margy	F
Mahalia	F
Madalene	F
Love	F
Loura	F
Lorean	F
Lewis	F
Lesha	F
Leonida	F
Lenita	F
Lavone	F
Lashell	F
Lashandra	F
Lamonica	F
Kimbra	F
Katherina	F
Karry	F
Kanesha	F
Julio	F
Jong	F
Jeneva	F
Jaquelyn	F
Hwa	F
Gilma	F
Ghislaine	F
Gertrudis	F
Fransisca	F
Fermina	F
Ettie	F
Etsuko	F
Ellis	F
Ellan	F
Elidia	F
Edra	F
Dorethea	F
Doreatha	F
Denyse	F
Denny	F
Deetta	F
Daine	F
Cyrstal	F
Corrin	F
Cayla	F
Carlita	F
Camila	F
Burma	F
Bula	F
Buena	F
Blake	F
Barabara	F
Avril	F
Austin	F
Alaine	F
Zana	F
Wilhemina	F
Wanetta	F
Virgil	F
Vi	F
Veronika	F
Vernon	F
Verline	F
Vasiliki	F
Tonita	F
Tisa	F
Teofila	F
Tayna	F
Taunya	F
Tandra	F
Takako	F
Sunni	F
Suanne	F
Sixta	F
Sharell	F
Seema	F
Russell	F
Rosenda	F
Robena	F
Raymonde	F
Pei	F
Pamila	F
Ozell	F
Neida	F
Neely	F
Mistie	F
Micha	F
Merissa	F
Maurita	F
Maryln	F
Maryetta	F
Marshall	F
Marcell	F
Malena	F
Makeda	F
Maddie	F
Lovetta	F
Lourie	F
Lorrine	F
Lorilee	F
Lester	F
Laurena	F
Lashay	F
Larraine	F
Laree	F
Lacresha	F
Kristle	F
Krishna	F
Keva	F
Keira	F
Karole	F
Joie	F
Jinny	F
Jeannetta	F
Jama	F
Heidy	F
Gilberte	F
Gema	F
Faviola	F
Evelynn	F
Enda	F
Elli	F
Ellena	F
Divina	F
Dagny	F
Collene	F
Codi	F
Cindie	F
Chassidy	F
Chasidy	F
Catrice	F
Catherina	F
Cassey	F
Caroll	F
Carlena	F
Candra	F
Calista	F
Bryanna	F
Britteny	F
Beula	F
Bari	F
Audrie	F
Audria	F
Ardelia	F
Annelle	F
Angila	F
Alona	F
Allyn	F
