about	P
admire	Vt
arms	pBbd
around	P
ass	NBbd
awesome	!A
balls	b
bed	N
boobs	d
booger	N
chains	p
chew	Vt
chin	NBbd
Damn	!
disgusting	A
ear	NB
ears	pBbd
eat	Vt
enormous	A
eyes	Bbd
face	NB
far out	!
fecund	A
fetid	A
finger	NBbdVt
food	N
foot	Bbd
for	P
gigantic	A
grab	Vt
greedily	v
groovy	A
grope	Vi
hair	NBbd
he	rN
her	r
his	Dr
Holy crap	!
hot	A
I'd	N
in	P
into	P
it	rN
Jell-O	N
legs	pBbd
like	Vt
lips	Bbd
loudly	v
love	Vt
make whoopee	Vi
my God	!
my	P
noisilly	v
of	P
oh my	!
on	P
over	P
readily	v
revolting	A
rub	Vt
she	rN
slimy	A
sloppy	A
soft	A
the bomb	A
them	rp
they	rp
tickle	Vti
to	P
toe	NBbd
toes	pBbd
tongue	Bbd
us	rp
used	A
want	Vt
we	rp
wet	A
whip	N
wildly	v
with	P
red	c
orange	c
yellow	c
blue	c
indigo	c
violet	c
puce	c
shit-brindle brown	c
brown	c
gray	c
white	c
teal	c
coldsore-red	c
pink	c
flesh-colored	c
off-white	c
royal blue	c

