about	P
admire	Vt
anal	A
anal canal	h
anal intercourse	h
anal impaler	Nhb
anus	NB
arms	pB
around	P
arse	NB
ass	NB
ass hole	NB
asshole	NB
ass wipe	N
badonkadonk	Nd
bald-headed yogurt slinger	Nhb
ball	Vt
balls	pb
baloney pony	Nhb
bang	Vt
bazongas	pd
bazooms	pd
bearded clam	Nhd
bearded oyster	Nhd
beaver	Nd
bed	N
belly	NB
between	P
bite	Vt
blindfold	N
blindfolded	A
blow	Vt
boink	Vt
boner	Nb
boobs	pd
booger	N
booty	Nd
breast	Nd
buccal	A
bum	NB
butt	NB
butt fuck	Vti
butt hole	NB
butt plug	N
carress	Vt
cavernous	A
caverns	p
chains	p
chew	Vt
chin	NB
clit	Nd
clitoris	Nd
cock	Nb
cock ring	N
condom	N
couch	N
cram it in	Vt
crap	N
creamy	A
cream pie	N
cum	NVi
cum on	Vt
cum over	Vt
cunt	Nd
dank	A
dick	Nb
dildo	N
dingis	Nb
disgusting	A
doggie-style	N
dong	Nb
douchbag	N
ear	NB
ears	pB
eat	Vt
enormous	A
face	NB
fecund	A
fetid	A
finger	NBVt
finger fuck	Vt
fingers	pB
fist fuck	Vt
fist	B
flacid	A
food	N
for	P
fuck	VN!
fuck hole	Nd
fuckhead	N
fun bags	phd
fur burger	Nhd
fur pie	Nhd
furry	A
gazongas	pd
gigantic	A
gonad	NBb
gonads	pBb
grab	Vt
greedily	v
grope	Vi
hair	NB
hair pie	N
hairy	A
hard	A
hard on	Nb
he	rN
her	r
hiney	NB
hiney hole	NB
hirsuit	A
his	Dr
Holy crap!	!
Holy shit!	!
hooters	pd
hot	A
hump	Vt
I'd	N
in	P
into	P
it	rN
jack off	NV
Jell-O	N
jerk	VtN
jerk off	NV
jizz	NVi
jizz on	Vt
Johnson	Nb
joystick	Nb
jugs	pd
kiss	Vti
KY-Jelly	NL
legs	pB
lick	Vt
like	Vt
lips	NpB
load	Nb
loudly	v
love	Vt
love juice	NB
love muscle	Nb
love shaft	Nb
love sheath	Nd
love stick	Nb
love sword	Nb
make love	Vi
make whoopee	Vi
mammaries	pd
melons	pd
member	Nb
my God!	!
my	P
nibble	Vb
noisilly	v
of	P
on	P
one-eyed snake	Nhb
one-eyed trouser snake	Nhb
oral	A
orgasm	N
orgasms	p
over	P
package	Nb
pee	i
pee on	Vt
penis	Nb
penis face	N
pink sausage wallet	Nhd
piss	Vi
piss flaps	Nd
pissing	V
piss on	Vt
poke	Vt
prick	Nb
prod	Vt
pump	Vt
pussy	Nd
readilly	v
retarded	A
revolting	A
rod	Nb
rub	Vt
sack	Nb
scratch	Vt
screw	Vt
scrotum	Nb
scumbag	N
semen	Nb
she	rN
shit	N
skank	N
skanky	A
slimy	A
sloppy	A
smelly	A
snatch	Nd
soft	A
soggy	A
spit	NVit
spunky	A
squirt	Vi
squirt on	Vt
stairs	N
steaming	A
steamy	A
stick it in	Vt
stinky	A
suck	Vt
sucky	A
swallow	Vt
taint	NBdb
take a dump on	Vt
tampon	N
testes	pb
testis tooth	Nh
them	rp
they	rp
thigh	NB
tickle	Vti
tits	pd
to	P
toe	NB
toes	pB
tongue	NB
tongue fuck	Vt
touch hole	NB
Trojan	NL
twat	Nd
us	rp
used	A
vagina	Nd
vaginal	A
wank on	Vt
want	Vt
we	rp
wet	A
whang	Nb
whip	N
wildly	v
with	P
